NO ./textures/cobble_wall.xpm

SO ./textures/cobble_shelf.xpm

WE ./textures/cobble_window.xpm

EA ./textures/cobble_lantern.xpm


F 120,120,100

C 10,50,198




        1111111111111111111111111
        100000000011S000000000001
        1011000001110000000000001
        1001000000000000000000001
111111111011000001110000000000001
100000000011000001110111111111111
11110111111111011100000010001
11110111111111011101010010001
11000000110101011100000010001
10000000000000001100000010001
10000000000000001101010000001
11000001110101011111011110001                  
11110111 1110101 101111010001                  
11111111 1111111 111111111111               