NO ./textures/cobble_wall.xpm

SO ./textures/cobble_shelf.xpm

F          120,120,100

WE          ./textures/cobble_window.xpm

EA ./textures/cobble_lantern.xpm

C 10,50,198


        1111111111111111111111111
        100000000011000D000DD0001
        1011000001110000000000001
        10010000000D000N000000001
111111111D110000011100000000D0001
10000000001100000111D111111111111
1111D111111111011100000010001
11110111111111011101010010001  
11000000110101011100000010001     
100000000000000011D0000010001 
11000001110101011111011110001               
11110111 1110101 101111010001                  
11111111 1111111 111111111111 